##################################################################
                                       (                          
                                       *                          
                                       *                          
                 #                     *                          
                ##                     *                          
                 #               (     *                          
                 #               *     )                          
                ###              )                                
##################################################################