#####################$#############$###########$#############$#########################$########$#%%%%%%#$$$#%%%%%%#$$################################
.....................$............#$#..........$......#######$#######..........########$.......#$#......#$$$#......#$$#...........####################
.....................$............#$#..........$......#######$#######..........########$.......#$#......#$$$#......#$$#..............#################
.....................$............#$#..........$.............%.........................$.......###......#####......####...............(...............
.....................$............###....$.............................................$..............................................*...............
.............$...............$...........$.....................................$......................................................*...............
.............$...............$...........$...............%.......%.............$......................................................)...............
.............$...............$###########$............###$#######$###..........$########........#########...########.................#################
.............$...............$###########$............###$#######$###..........$########........#$$$$$$$#...#$$$$$$#..............####################
#############$###############$###########$###############$#######$#############$#################$$$$$$$#%%%#$$$$$$###################################