##########$$$$####################$$$$#########$$#####$$#####$$#######%####%####%##$$$$$$$$$$$$$$$$$$$$$$$$$$$#############$$#########################
.........#$$$$#..................#$$$$#...............$$............##$####$####$##..........$$$$$$$$.......$$............#$$#...%#$$$$$$$$$$$$$$$$$$$
.........#$$$$#..................#$$$$#...............$$............##$####$####$##..........########.......$$............#$$#....####################
.........#%%%%#..................#$$$$#...............$$............##$####$####$##.........................##.....####...#$$#.....(..................
.........######....########......#$$$$#........$$.....$$.....$$............$.......................................#$$#...####.....*..................
...................#%%%%%%#......#%%%%#........$$.....$$.....$$.......$.........$..................#######.........#$$#............*..................
...................#$$$$$$#......######........$$............$$.....##$####$####$##................$$$$$$$..##.....#$$#............)..................
...................#$$$$$$#....................$$............$$.....##$####$####$##.########.......$$$$$$$..$$.....#$$#...........####################
...................#$$$$$$#....................$$............$$.....##$####$####$##.$$$$$$$$.......$$$$$$$..$$.....#$$#..........%#$$$$$$$$$$$$$$$$$$$
####################$$$$$$#####################$$#####$$#####$$#######%####%####%##$$$$$$$$$$$$$$$$$$$$$$$$$$$######$$$###############################