#######################$$$$$$$$$###########$$$$$$$################$#####$#######%%%%%%%##$##%%%%%%%#####$$$$$$$$$$$$$$##########%%#######$$#######$$#######$$#######$$#########$$#######################
......................#$$$$$$$$$#.........#$$$$$$$#.....................$......#$$$$$$$#.$.#$$$$$$$#....$...........#$#....................................$$................$$.........................
......................#$$$$$$$$$#.........#$$$$$$$#.....................$......#$$$$$$$#.$.#$$$$$$$#....$...........#$#....................................$$................$$.........................
......................#$$$$$$$$$#.........#$$$$$$$#...............$.....$......#########...#########....$...###.....#$#....................................$$................$$.....###.###.............
......................###########.........#$$$$$$$#...............$.....$...................................#$#.....#$#.........$$#######$$.......$$#######$$.......$$#######$$.....#...#...............
..........##########......................#########...............$.....$...................................#$#.....#$#.........$$#######$$.......$$#######$$.......$$#######$$.....#.#.#.#.............
..........#$$$$$$$$#......###.....................................$.....$......#########...#########........#$#.....###...$..............$$...................................(.....###.###.............
..........#$$$$$$$$#......#$#....#########.........#########......$............#$$$$$$$#.$.#$$$$$$$#........#$#...........$..............$$...................................*.........................
..........#$$$$$$$$#......#$#....#$$$$$$$#.........#$$$$$$$#......$............#$$$$$$$#.$.#$$$$$$$#........#$#...........$..............$$...................................).........................
###########$$$$$$$$########$######$$$$$$$#%%%%%%%%%#$$$$$$$#######$#####$#######%%%%%%%##$##%%%%%%%##########$$$$$$$$$$$$$$#####$$#######$$#######%%#######$$#######%%#########$$#######################
