#$$$$$$$##############################################$$$$$###$######$##$##$##$##$##$######################$$$############################$##$$$$$$$$$#############$################$$$$$$$$$$$$$$$$$$$$
#$$$$$$$#..........%.......%...##......##............#$$$$$#.#$#........$.....$.....$..........%%.%%.%....#$$$#..............%.....%......$.#$$$$$$$$$#...........#$#..............#$$$$$$$$$$$$$$$$$$$$
#$$$$$$$#......%.......%.......##......##............#$$$$$#.#$#...........................%...%..%%......#$$$#..$$.......%.....%.....%...$.#$$$$$$$$$#...........#$#..............#$$$$$$$$$$$$$$$$$$$$
#$$$$$$$#......#############.......##................#######.#$#.....$.....$.....$......####.......%......###$#.$..$....##%#####%#####%###$.#$$$$$$$$$#...........#$#..............#####################
#$$$$$$$#......#$$$$$$$$$$$#.......##........................#$#.....$##$##$##$##$##$...#$$#.####...........#$#....$......%.....%.....%...$.#$$$$$$$$$#.....#%#...#$#...#%#........(....................
#$$$$$$$#......#$$$$$$$$$$$#$$$$$$$$$$$$$$$$$$$........%.....#$#.....$##$##$##$##$##$...#$$#.#$$#.####......#$#...$..........%.....%......$.#########$#.....#$#...#%#...#$#........)....................
#$$$$$$$#......#$$$$$$$$$$$#....$....$....$.....########.....#$#........$.....$.....$...#$$#.#$$#.#$$#......###.........#####%#####%######$.........#$#.....#$#.........#$#........#####################
#########......#$$$$$$$$$$$#....$....$....$.....#$$$$$$#.....###........................#$$#.#$$#.#$$#.%..........$..........%.....%.........###....###.....#$#.........#$#........#$$$$$$$$$$$$$$$$$$$$
...............#$$$$$$$$$$$#....$....$....$.....#$$$$$$#.............$.....$.....$......#$$#.#$$#.#$$#.%%%................%.....%.....%......#$#............#$#.........#$#........#$$$$$$$$$$$$$$$$$$$$
################$$$$$$$$$$$#####%####%####%######$$$$$$##############$##$##$##$##$##$####$$###$$###$$#####################################$###$##############$###########$##########$$$$$$$$$$$$$$$$$$$$
