#####################$$$#%%%%#$$$$$$$#%#$$$$################################$#%%%%#$#%%%%#$#####$$$$$$$$$$$######$$$$$$$$$$$$$$#####$$$$$$$$$#%%#$$$$$$$$$#######$$$$$$$$$$###$$$$$###$$$$$$$$$$$$$$#########$$$$$$$####################*#################
..........##........#$$$#....#$$$$$$$#.#$$$$#...........$...$........%.....#$#....#$#....###...#$$$$$$$$$$$#...........$%..........#$$$$$$$$$#..#$$$$$$$$$#.....#$$$$$$$$$$#.#$$$$$#.#$$$$$##########.......##$$$####.......%%..%.......*.................
..........##........#$$$#....#$$$$$$$#.#$$$$#..............................###....#$#......$...#$$$$$$$$$$$#...........$$..........#$$$$$$$$$#..##$#####$##.....#$$$$$$$$$$#.#######.#$$$$$#..%%%............##$$#..........%..........$$$.$$..$$$.$$.....
..........##........#$$$#....#$$$$$$$#.######..........$$$.$$$.$..%.....%.........#$#..........#$$$$$$$$$$$#...........%$..........#$$$$$$$$$#....$.....$.......############.........##$$$$#..................####....%%%%.............$*$.$.$.$...$.$....
.......%......%.....#$$$#....#########.................$...$.$.$..#######.........###..........#############.....%$....$$....%$....#####$#####.......$..............$......$..........######..........%%%.....%......##########........$*$.$$..$$..$.$....
.......########.....#####..............................$.$.$.$....#######...........$....$.....##.........##.....$$....$%....$$.........$.......#####$#####.....$.........................%%...%..##########%.......##$$$$$$$$##.......$*$.$.$.$...$.$....
.......#$$$$$$#....................#####...............$$$.$$$.$..%.....%...$............###...%%.........%%.....$%..........$%......$.....$....#$$$$$$$$$#.###########...$.$$................#####$$$$$$$$###......#$$$$$$$$$$#.......$*$.$.$.$...$.$....
.......#$$$$$$#.........#########..#$$$#....########.......................###...........#$#........###..........$$..........$$....##$#####$##..#$$$$$$$$$#.#$$$$$$$$$#.#######.....$.........#$$$$$$$$$$$$$$#####..#$$$$$$$$$$#.......$$$.$$..$$$.$$.....
.......#$$$$$$#.........#$$$$$$$#..#$$$#....#$$$$$$#....$...$........%.....#$#.....$.....#$#........#$#..........%$..........%$....#$$$$$$$$$#..#$$$$$$$$$#.#$$$$$$$$$#.#$$$$$#.$.$$$$$....%..#$$$$$$$$$$$$$$$$$$#%.#$$$$$$$$$$#........*.................
########$$$$$$###########$$$$$$$#%%#$$$#%%%%#$$$$$$#########################$#%%%%###%%%%#$##########$###########$$$$$$$$$$$$$$#####$$$$$$$$$#%%#$$$$$$$$$###$$$$$$$$$###$$$$$#################$$$$$$$$$$$$$$$$$$####$$$$$$$$$$#########*#################